NO ./maps/assets/jcuzin.xpm
EA ./maps/assets/eguelin.xpm
WE ./maps/assets/ldurieux.xpm
SO ./maps/assets/aammirat.xpm

F 0, 255, 255
C 182, 247, 25

                                                                                                         
                                                                                                         
                                                                                      
111111111111111111111111111111111111111111111111111111111111111111111111111111111111  
100000000000000000000000000000000000000000000000000000000000000000000000000000000001  
100011111111111111110000111100000000000000001111111111111111000111100000000011110001  
100011111111111111110000111100000000000000001111111111111111000011110000000111100001  
10001111000000000000000011110000000000000000111100000000000000000111100000111100000111111111111  
10001111000000000000000011110000000000000000111100000000000000000011110001111000000000000000001  
10001111111111111111000011110000000000000000111100000000000000000001111011110000000000000000001  
10001111111111111111000011110000000000000000111111111111111100000000111111100000000111111111111  
100011110000000000000000111100000000000000001111111111111111000000000111110000000001  
100011110000000000000000111100000000000000001111111111111111000000001111111000000001  
100011110000000000000000111100000000000000001111000000000000000000011110111100000001  
10001111000000000000000011110000000000000000111100000000000000000011110001111000011111111111111111111111  
10001111000000000000000011110000000000000000111100000000000000000111100000111100000000000000000000000001  
10001111000000000000000011111111111111110000111111111111111100001111000000011110000000000000000000000001  
10001111000000000000000011111111111111110000111111111111111100011110000000001111000000000000000000000001  
10000000000000000000000000000000000000000000000000000000000000000000000000000000000000000000000000000001  
100000000000N00000100000000000000000000000000000000000000000000000000000000000000000000000000000000000001  
10000000000000000000100000000011111100000000000000000000000000000000000000000000000000000000000000000001  
1000000000000000000000000000001    100000000000000000000000000000000000000000000000000000000000000000001  
1000000000000000000000000000001    100000000000000000000000000000000000000000000000000000000000000000001  
1111111111111111111111111111111    111111111111111111111111111111111111111111111111111111111111111111111 
                                                                                                         
                                                                                                         
                                                                                                         
                                                                                                         
                                                                                                       