NO ./maps/assets/ldurieux.xpm
EA ./maps/assets/aammirat.xpm
WE ./maps/assets/jcuzin.xpm
SO ./maps/assets/llevasse.xpm

F 153, 153, 153

C 182, 247, 255


                                                                                                                                  
  111111111111111111111111111111111111111111111111111111111111111111111111111111111111  
  100000000000000000000000000000000000000000000000000000000000000000000000000000000001  
  100011111111111111110000111100000000000000001111111111111111000111100000000011110001  
  100011111111111111110000111100000000000000001111111111111111000011110000000111100001  
  100011110000000000000000111100000000000000001111000000000000000001111000001111000001  
  100011110000000000000000111100000000000000001111000000000000000000111100011110000001  
  100011111111111111110000111100000000000000001111000000000000000000011110111100000001  
  100011111111111111110000111100000000000000001111111111111111000000001111111000000001  
  100011110000000000000000111100000000000000001111111111111111000000000111110000000001  
  100011110000000000000000111100000000000000001111111111111111000000001111111000000001  
  100011110000000000000000111100000000000000001111000000000000000000011110111100000001  
  100011110000000000000000111100000000000000001111000000000000000000111100011110000001  
  100011110000000000000000111100000000000000001111000000000000000001111000001111000001  
  100011110000000000000000111111111111111100001111111111111111000011110000000111100001  
  100011110000000000000000111111111111111100001111111111111111000111100000000011110001  
  100000000000000000000000000000000000000000000000000000000000000000000000000000000001  
  100000000000N00000000000000000000000000000000000000000000000000000000000000000000001  
  100000000000000000000000000000000000000000000000000000000000000000000000000000000001  
  100000000000000000000000000000000000000000000000000000000000000000000000000000000001  
  100000000000000000000000000000000000000000000000000000000000000000000000000000000001  
  111111111111111111111111111111111111111111111111111111111111111111111111111111111111  
                                                                                                                                  