
EA ./east_texture

NO ./north_texture

WE ./west_texture

SO ./south_texture

F 123    ,256  ,   +211


C     999  ,30   ,-8




         1111111111111111111111111
         1000000000110000000000001
         1011000001110000000000001
         1001000000000000000000001
111111111011000001110000000000001
100000000011000001110111111111111
11110111111111011100000000001
11110111111111011101010010001
11000000110101011100000010001
10000000000000001100000010001
1000000N000000001101010010001
1100000111010101111101111001000000010
11110111 100101 101111010001
11111111 1111111 111111111111