NO ./maps/assets/jcuzin.xpm
EA ./maps/assets/eguelin.xpm
WE ./maps/assets/ldurieux.xpm
SO ./maps/assets/aammirat.xpm

F 0, 255, 35 

C 182, 247, 255

11111111111111111111     
10000000000000000001     
1000N000000000000001     
10000000000000000001     
10000000000000000001     
10000000000000000001     
11111111111111111111     